?0?00?0?0???00?000??00?00?00000?0
-0000000100000000000000000000000?
00000000100000000000000000000000?
?00000000000000000000000000000000
?0000000000000000001111100001110?
01110000000000000001000000000000?
?00000000000000000000000000000000
?00000000000000000000000000000000
000000000000000000000000000000000
?0000011110000000000111111000000?
000000010000000000000000000000000
?0000000000000000000000000000000?
?10000000000000000000000000000000
01100000000000001111000000000000?
?00000000000000000000000000000000
?0000000000000*00000000000000000?
?00000000000000000000000011111100
00000000111100000000000000000100?
000000000000000000000000000000000
?0000000000000000000000000000000?
?000000000000000000000000000000.0
00000000000100000000000000011000?
000000000001000000000000000001000
?00?00?00?0000?00??0000??0?0010??