????????????????????????????????
?000000000000000000000000-00000?
?000000000000000000000000000000?
?000000000000000000000000000000?
?000000000000000000111111111110?
?111000000111111111100000000010?
?000000000000001000000000000000?
?000000000000001000000000000000?
?000000000000000000000000000010?
?000001110000000000011111111110?
?000000110000000000000000000000?
?000000010000000000000000000000?
?000000000000000000000000000000?
?000000011111000000000000000010?
?000000000000000000000000000010?
?000000000000000000000000000000?
?000000000000000000000000111111?
?000000011111000000000000000010?
?000000000000000000000000000000?
?000000000000000000000000000000?
?000000111110000000000000000000?
?000000000010000000000000000000?
?00000000001000000000000000*000?
????????????????????????????????