????????????????????????????????
?-00000010000000000000000000000?
?000000010000000000000000000000?
?000000000000000000000000000000?
?000000000000000000111111111111?
?111000000000000000100000000000?
?000000000000000000000000000000?
?000000000000000000000000000000?
?000000000000000000000000000000?
?000001110000000000011111111111?
?000000110000000000000000000000?
?000000010000000000000000000000?
?000000000000000000000000000000?
?111111000001100111100000000111?
?000000000000000000000000000000?
?000000000000000000000000000000?
?000000000000000000000000111111?
?000000011111000000000000000010?
?000000000000000000000000000000?
?000000000*00000000000000000000?
?000000000000000000000000000000?
?000000000010000000000000000000?
?000000000010000000000000000010?
????????????????????????????????