?0?00?0?0???00?000??00?00?000000
0-00000010000000000000000000000?
0000000010000000000000000000000?
?0000000000000000000000000000000
?000000000000000000111110000111?
0111000000000000000100000000000?
?0000000000000000000000000000000
?0000000000000000000000000000000
00000000000000000000000000000000
?000001111000000000011111100000?
00000001000000000000000000000000
?000000000000000000000000000000?
?1000000000000000000000000000000
0110000000000000111100000000000?
?0000000000000000000000000000000
?0000000000000*0000000000000000?
?0000000000000000000000001111110
0000000011110000000000000000010?
00000000000000000000000000000000
?000000000000000000000000000000?
?0000000000000000000000000000000
0000000000010000000000000001100?
00000000000100000000000000000100
?00?00?00?0000?00??0000??0?0010?