00000000000000000000000000000000
0-000000100000000000000000000000
00000000100000000000000000000000
00000000000000000000000000000000
00000000000000000001111110001110
01110000000000000001000000000000
00000000000000000000000000000000
00000000000000000000000000000000
00000000000000000000000000000000
00000011110000000000111111000000
00000001000000000000000000000000
00000000000000000000000000000000
01000000000000000000000000000000
01100000000011001111000000000000
00000000000000000000000000000000
00000000000000*00000000000000000
00000000000000000000000001111110
00000000111110000000000000000100
00000000000000000000000000000000
00000000000000000000000000000000
00000000000000000000000000000000
00000000000100000000000000011000
00000000000100000000000000000100
00000000000000000000000000000100